.P....|.F.@|....@.
.{>...[>. <]...<}.
.|@ ^. ......^.@|.
.[>.v.<>  <>.v.<].
..................
